111111111111111
1001000001001C1
100001101100101
1C0011E10111101
100000000000001
100000101111111
110111100000111
1000000000000P1
111111111111111