11111111111111111111111111111111
1PC000C00100E0000000000000000001
10000000000100000000000000000001
11111111111111111111111111111111