11111111111111111111111111111111
1001000001001C000000000000000001
11100110110010000000000000000001
1C101101011110000000000000000001
10100000000000000000000000000001
1010001E111111000000000000000001
10011110000011000000000000000001
10000000000000000001111000000001
1000000000000000000CCCC000000001
1000000000000000000CCCC000000001
1000000000000000000CCCC0000000P1
11111111111111111111111111111111
11111111111111111111111111111111
11111111111111111111111111111111