11111111111111111111
10000000M000000CE111
1000M000000000011001
10000000M00000011001
1P000000000000011001
11111111111111111111