11111111111111111111111111111111
1PC0000000C0000CE000000000000001
11111111111111111111111111111111