1111111111111111111111111
1E10000000000000000000001
1010111111111111111111111
1000000000000000000000001
1001111111111111111111111
1000000100010001000100011
1000010001000100010001001
101C011111111111111111111
10000000000000000000000C1
1111111111111111111111111