11111111111111111111111111111
1E100000000000000000000011111
10101111111111111111111111111
10000000000000000000000011111
10011111111111111111111111111
10000001000100010001000111111
10000100010001000100010011111
101C0111111111111111111111111
100000000000000000000P0C11111
11111111111111111111111111111