11111111111111111111111111111111111111111
1E000000000000000000000000000000000000001
1P001111111111111111111111111111111111111
10000000000000000000000000000000000000001
10011111111111111111111111111111111111111
10000001000100010001000100010001000100011
10000100010001000100010001000100010001001
101C0111111111111111111111111111111111111
101001000000000000000M0000M00000000000001
11111111111111111111111111111111111111111