11111111111111111111111111111111111111111
1E100000000000000000000000000000000000001
1P101111111111111111111111111111111111111
10100000000000000000000000000000000000001
10111111111111111111111111111111111111111
10000001000100010001000100010001000100011
10111100010001000100010001000100010001001
101C0111111111111111111111111111111111111
10100100000000000000000000000000000000001
11111111111111111111111111111111111111111