111111111111111111111111111111111111111111111111111111111111111111111111111111111111111111111111111111111111111111111
1E0000000C000000000M0000000C00000000000000000000000000000000000000000000000000000000000000000000000000000000000000001
111111111100001111111111111100000000000000000000000000000000000000000000000000000000000000000000000000000000000000001
10000000C1000C0000000000000C00000000000000000000000000000000000000000000000000000000000000000000000000000000000000001
1CM00000000000000C000000000000000000000000000000000000000000000000000000000000000000000000000000000000000000000000001
111111110111111111111111100000000000000000000000000000000000000000000000000000000000000000000000000000000000000000001
10001111111101C000000C00000000000000000000000000000000000000000000000000000000000000000000000000000000000000000000011
111110000001111101111111111100000000000000000000000000000000000000000000000000000000000000000000000000000000000000001
1P000000C0C00000C0000000000C00000000000000000000000000000000000000000000000000000000000000000000000000000000000000001
111110000001111101111111111100000000000000000000000000000000000000000000000000000000000000000000000000000000000000001
111110000001111101111111111100000000000000000000000000000000000000000000000000000000000000000000000000000000000000001
111110000001111101111111111100000000000000000000000000000000000000000000000000000000000000000000000000000000000000001
111110000001111101111111111100000000000000000000000000000000000000000000000000000000000000000000000000000000000000001
111110000001111101111111111100000000000000000000000000000000000000000000000000000000000000000000000000000000000000001
111110000001111101111111111100000000000000000000000000000000000000000000000000000000000000000000000000000000000000001
111110000001111101111111111100000000000000000000000000000000000000000000000000000000000000000000000000000000000000001
111110000001111101111111111100000000000000000000000000000000000000000000000000000000000000000000000000000000000000001
111110000001111101111111111100000000000000000000000000000000000000000000000000000000000000000000000000000000000000001
111110000001111101111111111100000000000000000000000000000000000000000000000000000000000000000000000000000000000000001
111110000001111101111111111100000000000000000000000000000000000000000000000000000000000000000000000000000000000000001
111110000001111101111111111100000000000000000000000000000000000000000000000000000000000000000000000000000000000000001
111110000001111101111111111100000000000000000000000000000000000000000000000000000000000000000000000000000000000000001
111110000001111101111111111100000000000000000000000000000000000000000000000000000000000000000000000000000000000000001
111110000001111101111111111100000000000000000000000000000000000000000000000000000000000000000000000000000000000000001
111110000001111101111111111100000000000000000000000000000000000000000000000000000000000000000000000000000000000000001
111110000001111101111111111100000000000000000000000000000000000000000000000000000000000000000000000000000000000000001
111110000001111101111111111100000000000000000000000000000000000000000000000000000000000000000000000000000000000000001
111110000001111101111111111100000000000000000000000000000000000000000000000000000000000000000000000000000000000000001
111110000001111101111111111100000000000000000000000000000000000000000000000000000000000000000000000000000000000000001
111110000001111101111111111100000000000000000000000000000000000000000000000000000000000000000000000000000000000000001
111110000001111101111111111100000000000000000000000000000000000000000000000000000000000000000000000000000000000000001
111110000001111101111111111100000000000000000000000000000000000000000000000000000000000000000000000000000000000000001
111110000001111101111111111100000000000000000000000000000000000000000000000000000000000000000000000000000000000000001
111110000001111101111111111100000000000000000000000000000000000000000000000000000000000000000000000000000000000000001
111110000001111101111111111100000000000000000000000000000000000000000000000000000000000000000000000000000000000000001
111110000001111101111111111100000000000000000000000000000000000000000000000000000000000000000000000000000000000000001
111110000001111101111111111100000000000000000000000000000000000000000000000000000000000000000000000000000000000000001
111110000001111101111111111100000000000000000000000000000000000000000000000000000000000000000000000000000000000000001
111110000001111101111111111100000000000000000000000000000000000000000000000000000000000000000000000000000000000000001
111110000001111101111111111100000000000000000000000000000000000000000000000000000000000000000000000000000000000000001
111110000001111101111111111100000000000000000000000000000000000000000000000000000000000000000000000000000000000000001
111110000001111101111111111100000000000000000000000000000000000000000000000000000000000000000000000000000000000000001
111110000001111101111111111100000000000000000000000000000000000000000000000000000000000000000000000000000000000000001
111110000001111101111111111100000000000000000000000000000000000000000000000000000000000000000000000000000000000000001
111110000001111101111111111100000000000000000000000000000000000000000000000000000000000000000000000000000000000000001
111110000001111101111111111100000000000000000000000000000000000000000000000000000000000000000000000000000000000000001
111110000001111101111111111100000000000000000000000000000000000000000000000000000000000000000000000000000000000000001
111110000001111101111111111100000000000000000000000000000000000000000000000000000000000000000000000000000000000000001
111110000001111101111111111100000000000000000000000000000000000000000000000000000000000000000000000000000000000000001
111110000001111101111111111100000000000000000000000000000000000000000000000000000000000000000000000000000000000000001
111110000001111101111111111100000000000000000000000000000000000000000000000000000000000000000000000000000000000000001
111110000001111101111111111100000000000000000000000000000000000000000000000000000000000000000000000000000000000000001
111111111111111111111111111111111111111111111111111111111111111111111111111111111111111111111111111111111111111111111