11111111111111111111111111111
1E0000000C000000000M0000000C1
11111111110000111111111111111
10000000C1000C000000000000MC1
1C000000000000000C00000000001
11111111011111111111111110001
10001111111101C000000C00000C1
11111000000111110111111111111
1P000000C0C00000C0000000000C1
11111111111111111111111111111