11111111111111111111111111111111
1PC000C00100E0000000000000010001
11111111111111111111111111111111